TILEMAP
SIZE 20 20
FLOOR
0 0 0 0 0 0 0 0 0 0 0 0 0 0 0 0 0 0 0 0 
0 0 0 0 0 0 0 0 0 0 0 0 0 0 0 0 0 0 0 0 
0 0 0 0 0 0 0 0 0 0 0 0 0 0 0 0 0 0 0 0 
0 0 0 0 0 0 0 0 0 0 0 0 0 0 0 0 0 0 0 0 
0 0 0 0 0 0 0 0 0 0 0 0 0 0 0 0 0 0 0 0 
0 0 0 0 0 0 0 0 0 0 0 0 0 0 0 0 0 0 0 0 
0 0 0 0 0 0 0 0 0 0 0 0 0 0 0 0 0 0 0 0 
0 0 0 0 0 0 0 0 0 0 0 0 0 0 0 0 0 0 0 0 
0 0 0 0 0 0 0 0 0 0 0 0 0 0 0 0 0 0 0 0 
0 0 0 0 0 0 0 0 0 0 0 0 0 0 0 0 0 0 0 0 
0 0 0 0 0 0 0 0 0 0 0 0 0 0 0 0 0 0 0 0 
0 0 0 0 0 0 0 0 0 0 0 0 0 0 0 0 0 0 0 0 
0 0 0 0 0 0 0 0 0 0 0 0 0 0 0 0 0 0 0 0 
0 0 0 0 0 0 0 0 0 0 0 0 0 0 0 0 0 0 0 0 
0 0 0 0 0 0 0 0 0 0 0 0 0 0 0 0 0 0 0 0 
0 0 0 0 0 0 0 0 0 0 0 0 0 0 0 0 0 0 0 0 
0 0 0 0 0 0 0 0 0 0 0 0 0 0 0 0 0 0 0 0 
0 0 0 0 0 0 0 0 0 0 0 0 0 0 0 0 0 0 0 0 
0 0 0 0 0 0 0 0 0 0 0 0 0 0 0 0 0 0 0 0 
0 0 0 0 0 0 0 0 0 0 0 0 0 0 0 0 0 0 0 0 
WALL
-1 -1 -1 -1 -1 -1 -1 -1 -1 -1 -1 -1 -1 -1 -1 -1 -1 -1 -1 -1 
-1 -1 -1 -1 -1 -1 -1 -1 -1 -1 -1 -1 -1 -1 -1 -1 -1 -1 -1 -1 
-1 -1 -1 -1 -1 -1 -1 -1 69 69 69 69 69 69 -1 -1 -1 -1 -1 -1 
-1 69 69 69 69 69 69 69 69 69 -1 -1 -1 69 -1 -1 -1 -1 -1 -1 
-1 69 69 69 -1 69 69 69 69 69 69 -1 -1 69 69 69 69 -1 -1 -1 
-1 69 -1 -1 -1 69 69 -1 69 69 69 69 69 69 69 69 69 -1 -1 -1 
-1 69 -1 69 69 69 69 69 -1 69 -1 69 69 69 69 69 69 69 -1 -1 
-1 -1 69 69 69 69 -1 69 69 69 69 69 69 69 69 69 69 69 -1 -1 
-1 69 69 69 69 69 69 69 -1 69 69 69 69 69 -1 69 69 69 -1 -1 
-1 69 -1 69 69 69 69 69 -1 69 69 69 69 69 69 69 69 69 -1 -1 
69 -1 -1 -1 69 -1 69 69 69 69 69 69 69 69 69 69 69 69 -1 -1 
69 -1 -1 -1 -1 69 69 -1 69 69 69 69 69 69 69 69 69 69 -1 -1 
69 -1 -1 -1 -1 -1 69 69 69 69 69 69 -1 69 69 69 69 -1 -1 -1 
69 -1 -1 -1 -1 -1 -1 69 69 69 69 69 69 69 69 69 69 -1 -1 -1 
-1 69 -1 -1 -1 -1 69 69 69 69 69 69 69 69 -1 69 69 -1 -1 -1 
-1 -1 69 69 69 69 69 69 69 69 69 -1 -1 -1 69 69 69 -1 -1 -1 
-1 -1 -1 -1 -1 69 69 69 69 69 -1 -1 -1 69 69 -1 -1 -1 -1 -1 
-1 -1 -1 -1 -1 -1 -1 -1 69 69 69 69 69 69 -1 -1 -1 -1 -1 -1 
-1 -1 -1 -1 -1 -1 -1 -1 -1 -1 -1 69 69 -1 -1 -1 -1 -1 -1 -1 
-1 -1 -1 -1 -1 -1 -1 -1 -1 -1 -1 -1 -1 -1 -1 -1 -1 -1 -1 -1 
