TILEMAP
SIZE 20 20
FLOOR
0 0 0 0 0 0 0 0 0 0 0 0 0 0 0 0 0 0 0 0 
0 0 0 0 0 0 0 0 0 0 0 43 43 0 0 0 0 0 0 0 
0 0 0 0 0 0 0 0 0 43 43 0 0 0 0 0 0 0 0 0 
0 0 0 0 0 0 0 43 43 30 0 0 0 0 0 0 0 0 0 0 
0 0 0 0 0 43 43 0 0 30 30 0 30 30 0 30 30 30 0 0 
0 0 0 0 43 0 0 0 0 0 0 0 0 0 0 30 0 0 0 0 
0 0 0 0 43 0 0 0 0 0 0 0 0 30 0 0 0 43 0 43 
0 0 0 0 43 43 0 43 0 43 0 43 0 0 43 0 0 43 0 0 
0 0 0 0 0 0 0 30 0 0 30 30 30 30 43 0 0 0 0 0 
0 0 0 0 0 30 30 43 30 30 43 0 0 0 0 0 0 0 0 0 
0 0 0 30 43 30 30 30 0 30 30 43 43 43 43 0 0 0 0 0 
0 0 43 0 30 0 0 0 43 30 43 0 43 43 0 0 0 0 43 0 
43 43 43 43 0 43 43 30 30 0 0 43 30 30 30 43 43 43 43 0 
0 0 0 0 0 0 0 30 0 0 43 30 30 43 43 0 0 0 0 0 
0 0 0 0 0 0 0 43 43 30 0 0 43 0 0 0 0 0 0 0 
0 0 0 0 0 0 43 0 43 43 43 0 43 0 43 43 43 0 0 0 
0 0 0 0 0 0 43 43 43 43 43 43 0 43 0 43 0 0 0 0 
0 0 0 0 0 0 0 0 0 0 0 43 0 0 0 0 0 0 0 0 
0 0 0 0 0 0 0 0 43 43 0 0 0 0 0 0 0 0 0 0 
0 0 0 0 0 0 0 0 43 0 0 0 0 0 0 0 0 0 0 43 
WALL
-1 -1 -1 -1 -1 -1 -1 -1 -1 -1 -1 -1 -1 -1 -1 -1 -1 -1 -1 -1 
-1 -1 -1 -1 -1 -1 -1 -1 -1 -1 -1 -1 -1 -1 -1 -1 -1 -1 -1 -1 
-1 -1 -1 -1 -1 -1 -1 -1 -1 -1 -1 -1 -1 -1 -1 -1 -1 -1 -1 -1 
-1 -1 -1 -1 -1 -1 -1 -1 -1 -1 -1 -1 -1 -1 -1 -1 -1 -1 -1 -1 
-1 -1 -1 -1 -1 -1 -1 -1 -1 -1 -1 -1 -1 -1 -1 -1 -1 -1 -1 -1 
-1 -1 -1 -1 -1 -1 -1 -1 -1 -1 -1 -1 -1 -1 -1 -1 -1 -1 -1 -1 
-1 -1 -1 -1 -1 -1 -1 -1 -1 -1 -1 -1 -1 -1 -1 -1 -1 -1 -1 -1 
-1 -1 -1 -1 -1 -1 -1 -1 -1 -1 -1 -1 -1 -1 -1 -1 -1 -1 -1 -1 
-1 -1 -1 38 -1 -1 -1 -1 -1 -1 -1 -1 -1 -1 -1 -1 -1 -1 -1 -1 
-1 -1 -1 -1 38 38 -1 38 38 -1 38 -1 38 38 38 -1 -1 -1 -1 -1 
-1 -1 -1 -1 -1 -1 -1 -1 -1 -1 -1 -1 -1 38 38 -1 -1 -1 -1 -1 
-1 -1 -1 -1 -1 -1 -1 -1 -1 -1 -1 -1 38 -1 -1 -1 -1 -1 -1 -1 
-1 -1 -1 -1 -1 -1 -1 -1 -1 -1 -1 38 -1 -1 -1 -1 -1 -1 -1 -1 
-1 -1 -1 -1 -1 -1 -1 -1 -1 -1 38 -1 -1 -1 -1 -1 -1 -1 -1 -1 
-1 -1 -1 -1 -1 -1 -1 -1 38 38 -1 -1 -1 -1 38 38 38 -1 -1 -1 
-1 -1 -1 -1 -1 -1 -1 38 38 38 -1 38 38 38 -1 38 -1 -1 -1 -1 
-1 -1 -1 -1 -1 -1 -1 38 38 -1 -1 38 38 38 -1 -1 -1 38 38 38 
-1 -1 -1 -1 -1 -1 -1 -1 -1 -1 -1 38 38 -1 38 -1 38 -1 -1 -1 
-1 -1 -1 -1 -1 -1 -1 -1 -1 -1 -1 -1 -1 -1 -1 -1 -1 -1 -1 -1 
-1 -1 -1 -1 -1 -1 -1 -1 -1 -1 -1 -1 -1 -1 -1 -1 -1 -1 -1 -1 
