TILEMAP
SIZE 20 20
FLOOR
-1 -1 -1 -1 -1 -1 -1 -1 -1 -1 -1 -1 -1 -1 -1 -1 -1 -1 -1 -1 
-1 -1 -1 -1 -1 -1 -1 -1 -1 -1 -1 -1 -1 -1 -1 -1 -1 -1 -1 -1 
-1 -1 -1 -1 -1 -1 -1 -1 -1 -1 -1 -1 -1 -1 -1 -1 -1 -1 -1 -1 
-1 -1 -1 -1 -1 -1 -1 -1 -1 -1 -1 -1 45 45 45 -1 -1 -1 -1 -1 
-1 -1 -1 -1 -1 -1 -1 -1 -1 45 45 45 -1 -1 -1 -1 -1 45 45 -1 
-1 -1 -1 -1 -1 -1 -1 -1 45 -1 -1 -1 -1 -1 -1 45 45 45 -1 -1 
-1 -1 -1 -1 -1 -1 -1 45 -1 -1 -1 -1 45 45 45 32 -1 -1 -1 -1 
-1 -1 -1 -1 -1 -1 -1 45 -1 -1 45 45 45 -1 -1 32 32 32 -1 32 
-1 -1 -1 -1 -1 -1 -1 45 -1 45 45 32 -1 32 32 32 32 32 32 32 
-1 -1 -1 -1 -1 -1 45 32 32 45 32 -1 32 32 32 32 32 32 32 32 
-1 -1 -1 -1 32 32 32 45 32 32 32 32 45 32 32 45 32 -1 32 32 
-1 32 32 32 32 -1 32 32 32 32 45 32 32 45 -1 32 32 32 32 32 
-1 -1 -1 32 32 32 32 32 32 -1 32 45 32 32 -1 32 32 32 32 32 
-1 -1 32 32 32 32 32 -1 32 32 32 32 -1 32 32 32 32 32 32 32 
-1 32 -1 -1 -1 32 32 32 32 32 32 32 32 -1 32 32 32 32 32 32 
32 32 32 32 32 32 -1 32 32 -1 32 -1 32 -1 32 32 32 32 32 32 
-1 -1 32 -1 32 32 32 -1 32 -1 32 32 32 32 32 32 32 32 32 32 
32 32 -1 32 32 32 32 -1 32 32 32 32 32 32 32 32 32 32 32 32 
-1 -1 -1 32 32 32 32 32 32 32 32 32 32 32 32 32 32 32 -1 32 
-1 -1 -1 -1 -1 -1 32 32 32 32 32 32 32 32 32 32 32 32 32 32 
WALL
-1 -1 -1 -1 -1 -1 -1 -1 -1 -1 -1 -1 -1 -1 -1 -1 -1 -1 -1 -1 
-1 -1 -1 -1 -1 -1 -1 -1 -1 -1 -1 -1 -1 -1 11 11 -1 -1 -1 -1 
-1 -1 -1 -1 -1 -1 -1 -1 -1 -1 -1 -1 11 11 11 11 -1 -1 -1 -1 
-1 -1 -1 -1 -1 -1 -1 -1 -1 -1 11 -1 -1 -1 11 -1 -1 -1 -1 -1 
-1 -1 -1 -1 -1 -1 -1 -1 -1 11 -1 11 -1 11 -1 -1 -1 -1 -1 -1 
-1 -1 -1 -1 -1 -1 -1 11 11 -1 11 11 11 11 11 1 1 -1 -1 -1 
-1 -1 -1 -1 -1 11 11 11 11 11 11 11 11 11 11 1 1 -1 1 1 
-1 -1 11 11 11 11 11 -1 11 11 1 1 1 1 1 1 -1 -1 -1 -1 
-1 -1 -1 -1 -1 -1 -1 11 -1 1 11 11 1 11 11 11 11 11 11 11 
-1 -1 -1 -1 11 11 11 -1 11 1 1 -1 11 11 11 11 11 11 11 11 
-1 -1 -1 11 11 -1 -1 1 1 11 11 11 11 11 11 11 -1 11 -1 -1 
-1 -1 11 11 11 11 11 11 11 11 -1 11 11 -1 11 11 11 11 11 -1 
-1 -1 -1 11 11 11 11 -1 11 11 -1 11 11 11 11 11 -1 11 11 -1 
-1 11 11 11 11 11 11 11 11 -1 11 -1 11 11 11 11 11 -1 -1 -1 
11 11 11 11 11 11 11 11 11 11 11 11 -1 11 -1 11 -1 11 -1 -1 
11 11 11 11 -1 11 11 11 11 11 11 11 11 11 11 11 11 11 11 -1 
-1 11 11 11 11 11 -1 11 -1 11 -1 11 11 11 11 11 -1 11 -1 -1 
11 -1 11 -1 -1 -1 -1 -1 -1 11 11 11 -1 -1 -1 -1 -1 -1 -1 -1 
-1 11 -1 11 -1 -1 11 -1 11 11 11 11 11 11 11 11 11 11 11 11 
11 11 11 11 11 -1 11 -1 11 11 11 11 11 -1 11 11 11 -1 -1 -1 
