TILEMAP
SIZE 13 13
PLAYER_START 0 0
NEXT_STAGE 0 0
FLOOR
0 0 0 0 0 0 0 0 0 0 0 0 0 
0 0 0 0 0 0 0 0 0 0 0 0 0 
0 0 0 0 0 0 0 0 0 0 0 0 0 
0 0 0 0 0 0 0 0 0 0 0 0 0 
0 0 0 0 0 0 0 0 0 0 0 0 0 
0 0 0 0 0 0 0 0 0 0 0 0 0 
0 0 0 0 0 0 24 0 0 33 0 0 0 
0 0 0 0 0 0 0 0 0 0 0 0 0 
0 0 0 0 0 0 0 0 0 0 0 0 0 
0 0 0 0 0 0 0 0 0 0 0 0 0 
0 0 0 0 0 0 0 0 0 0 0 0 0 
0 0 0 0 0 0 0 0 0 0 0 0 0 
0 0 0 0 0 0 0 0 0 0 0 0 0 
WALL
57 57 57 57 57 57 57 57 57 57 57 57 57 
57 -1 -1 -1 -1 -1 -1 -1 -1 -1 -1 -1 57 
57 -1 -1 -1 -1 -1 -1 -1 -1 -1 -1 -1 57 
57 -1 -1 -1 -1 -1 -1 -1 -1 -1 -1 -1 57 
57 -1 -1 -1 -1 -1 -1 -1 -1 -1 -1 -1 57 
57 -1 -1 -1 -1 -1 -1 -1 -1 -1 -1 -1 57 
57 -1 -1 -1 -1 -1 -1 -1 -1 -1 -1 -1 57 
57 -1 -1 -1 -1 -1 -1 -1 -1 -1 -1 -1 57 
57 -1 -1 -1 -1 -1 -1 -1 -1 -1 -1 -1 57 
57 -1 -1 -1 -1 -1 -1 -1 -1 -1 -1 -1 57 
57 -1 -1 -1 -1 -1 -1 -1 -1 -1 -1 -1 57 
57 -1 -1 -1 -1 -1 -1 -1 -1 -1 -1 -1 57 
57 57 57 57 57 57 57 57 57 57 57 57 57 
