TILEMAP
SIZE 7 7
PLAYER_START 0 0
NEXT_STAGE 0 0
FLOOR
0 0 0 0 0 0 0 
0 0 0 0 0 0 0 
0 0 0 0 0 0 0 
0 0 0 0 0 0 0 
0 0 42 42 42 0 0 
0 0 0 0 0 0 0 
0 0 0 0 0 0 0 
WALL
45 45 45 45 45 45 45 
45 -1 -1 -1 -1 -1 45 
45 -1 -1 -1 -1 -1 45 
45 -1 -1 -1 -1 -1 45 
45 -1 -1 -1 -1 -1 45 
45 -1 -1 -1 -1 -1 45 
45 45 45 45 45 45 45 
