TILEMAP
SIZE 8 8
PLAYER_START 2 2
NEXT_STAGE 6 4
FLOOR
0 0 0 0 0 0 0 0 
0 0 0 0 0 0 0 0 
0 0 0 0 0 0 0 0 
0 0 0 0 0 0 0 0 
0 0 0 0 0 0 0 0 
0 0 0 0 0 0 0 0 
0 0 0 0 0 0 0 0 
0 0 0 0 0 0 0 0 
WALL
1 1 1 1 1 1 1 1 
1 -1 -1 -1 -1 -1 -1 19 
51 -1 -1 -1 -1 -1 -1 7 
4 -1 -1 -1 -1 -1 -1 51 
4 -1 -1 -1 -1 -1 -1 7 
19 -1 -1 -1 -1 -1 -1 19 
51 -1 -1 -1 -1 -1 -1 51 
51 5 51 2 2 5 4 1 
TORCH
0 0 0 0 0 0 0 0 
0 0 0 0 0 0 0 0 
1 0 0 0 0 0 0 0 
0 0 0 0 0 0 0 0 
0 0 0 0 0 0 0 1 
0 0 0 0 0 0 0 0 
0 0 0 0 0 0 0 0 
0 0 0 1 0 0 0 0 
