TILEMAP
SIZE 13 13

PLAYER_START 6 10
NEXT_STAGE 12 0

FLOOR
0 0 0 0 0 0 0 0 0 0 0 0 0 
0 0 0 0 0 0 0 0 0 0 0 0 0 
0 0 0 0 0 0 0 0 0 0 0 0 0 
0 0 0 0 0 0 0 0 0 0 0 0 0 
0 0 0 0 0 0 0 0 0 0 0 0 0 
0 0 0 0 0 0 0 0 0 0 0 0 0 
0 0 0 0 0 0 0 0 0 0 0 0 0 
0 0 0 0 0 0 0 0 0 0 0 0 0 
0 0 0 0 0 0 0 0 0 0 0 0 0 
0 0 0 0 0 0 0 0 0 0 0 0 0 
0 0 0 0 0 0 0 0 0 0 0 0 0 
0 0 0 0 0 0 0 0 0 0 0 0 0 
0 0 0 0 0 0 0 0 0 0 0 0 0 
WALL
58 58 58 58 58 58 58 58 58 58 58 58 58 
58 -1 -1 -1 -1 -1 -1 -1 -1 -1 -1 -1 58 
58 -1 -1 -1 -1 -1 -1 -1 -1 -1 -1 -1 58 
58 -1 -1 -1 -1 -1 -1 -1 -1 -1 -1 -1 58 
58 -1 -1 -1 -1 -1 -1 -1 -1 -1 -1 -1 58 
58 -1 -1 -1 -1 -1 -1 -1 -1 -1 -1 -1 58 
58 -1 -1 -1 -1 -1 -1 -1 -1 -1 -1 -1 58 
58 -1 -1 -1 -1 -1 -1 -1 -1 -1 -1 -1 58 
58 -1 -1 -1 -1 -1 -1 -1 -1 -1 -1 -1 58 
58 -1 -1 -1 -1 -1 -1 -1 -1 -1 -1 -1 58 
58 -1 -1 -1 -1 -1 -1 -1 -1 -1 -1 -1 58 
58 -1 -1 -1 -1 -1 -1 -1 -1 -1 -1 -1 58 
58 58 58 58 58 58 58 58 58 58 58 58 58 
TORCH
0 0 0 0 0 0 0 0 0 0 0 0 0 
0 0 0 0 0 0 0 0 0 0 0 0 0 
0 0 0 0 0 0 0 0 0 0 0 0 0 
0 0 0 0 0 0 0 0 0 0 0 0 0 
0 0 0 0 0 0 0 0 0 0 0 0 0 
0 0 0 0 0 0 0 0 0 0 0 0 0 
0 0 0 0 0 0 0 0 0 0 0 0 0 
0 0 0 0 0 0 0 0 0 0 0 0 0 
0 0 0 0 0 0 0 0 0 0 0 0 0 
0 0 0 0 0 0 0 0 0 0 0 0 0 
0 0 0 0 0 0 0 0 0 0 0 0 0 
0 0 0 0 0 0 0 0 0 0 0 0 0 
0 0 0 0 0 0 0 0 0 0 0 0 0 
