TILEMAP
SIZE 13 13
FLOOR
0 0 0 0 0 0 0 0 0 0 0 0 0 
0 0 0 0 0 0 0 0 0 0 0 0 0 
0 0 0 0 0 0 0 0 0 0 0 0 0 
0 0 0 0 0 0 0 0 0 0 0 0 0 
0 0 0 0 0 0 0 0 0 0 0 0 0 
0 0 0 0 0 0 0 0 0 0 0 0 0 
0 0 0 0 0 0 0 0 0 0 0 0 0 
0 0 0 0 0 0 0 0 0 0 0 0 0 
0 0 0 0 0 0 0 0 0 0 0 0 0 
0 0 0 0 0 0 0 0 0 0 0 0 0 
0 0 0 0 0 0 0 0 0 0 0 0 0 
0 0 0 0 0 0 0 0 0 0 0 0 0 
0 0 0 0 0 0 0 0 0 0 0 0 0 
WALL
58 58 59 58 59 58 59 58 58 58 58 58 58 
59 -1 -1 -1 -1 -1 -1 -1 -1 -1 -1 -1 59 
59 -1 -1 -1 -1 -1 -1 -1 -1 -1 -1 -1 58 
58 -1 -1 -1 -1 -1 -1 -1 -1 -1 -1 -1 58 
59 -1 -1 -1 -1 -1 -1 -1 -1 -1 -1 -1 58 
58 -1 -1 -1 -1 -1 -1 -1 -1 -1 -1 -1 59 
58 -1 -1 -1 -1 -1 -1 -1 -1 -1 -1 -1 58 
59 -1 -1 -1 -1 -1 -1 -1 -1 -1 -1 -1 59 
58 -1 -1 -1 -1 -1 -1 -1 -1 -1 -1 -1 58 
58 -1 -1 -1 -1 -1 -1 -1 -1 -1 -1 -1 59 
59 -1 -1 -1 -1 -1 -1 -1 -1 -1 -1 -1 58 
59 -1 -1 -1 -1 -1 -1 -1 -1 -1 -1 -1 59 
58 59 59 59 58 59 59 58 59 58 58 59 58 
