TILEMAP
SIZE 8 8
FLOOR
0 0 0 0 0 0 0 0 
0 0 0 0 0 0 0 0 
0 0 0 0 0 0 0 0 
0 0 0 0 0 0 0 0 
0 0 0 0 0 0 0 0 
0 0 0 0 0 0 0 0 
0 0 0 0 0 0 0 0 
0 0 0 0 0 0 0 0 
WALL
60 60 60 60 60 60 60 60 
60 -1 -1 -1 -1 -1 -1 60 
60 -1 -1 -1 -1 -1 -1 60 
60 -1 -1 -1 -1 -1 -1 60 
60 -1 -1 -1 -1 -1 -1 60 
60 -1 -1 -1 -1 -1 -1 60 
60 -1 -1 -1 -1 -1 -1 60 
60 60 60 60 60 60 60 60 
