TILEMAP
SIZE 8 8
PLAYER_START 0 0
NEXT_STAGE 0 0
FLOOR
0 0 0 0 0 0 0 0 
0 0 0 0 0 0 0 0 
0 0 0 0 0 0 0 0 
0 0 0 0 0 0 0 0 
0 0 0 0 0 0 0 0 
0 0 0 0 0 0 0 0 
0 0 0 0 0 0 0 0 
0 0 0 0 0 0 0 0 
WALL
1 1 1 1 1 1 1 1 
1 -1 -1 -1 -1 -1 -1 19 
51 -1 -1 -1 -1 -1 -1 7 
4 -1 -1 -1 -1 -1 -1 51 
4 -1 -1 -1 -1 -1 -1 7 
19 -1 -1 -1 -1 -1 -1 19 
51 -1 -1 -1 -1 -1 -1 51 
51 5 51 2 2 5 4 1 
