TILEMAP
SIZE 9 9
PLAYER_START 2 2
NEXT_STAGE 5 5
FLOOR
1 1 1 1 1 1 1 1 1 
1 1 1 1 1 1 1 1 1 
1 1 1 1 1 1 1 1 1 
1 1 1 1 1 1 1 1 1 
1 1 1 1 1 1 1 1 1 
1 1 1 1 1 1 1 1 1 
1 1 1 1 1 1 1 1 1 
1 1 1 1 1 1 1 1 1 
1 1 1 1 1 1 1 1 1 
WALL
3 3 3 12 12 12 3 51 51 
3 -1 -1 -1 -1 -1 -1 -1 51 
51 -1 -1 -1 3 -1 -1 -1 3 
51 -1 -1 -1 12 -1 -1 -1 3 
51 -1 -1 -1 12 3 -1 -1 3 
3 -1 3 -1 -1 -1 -1 -1 51 
3 -1 -1 -1 -1 -1 -1 -1 51 
51 -1 -1 -1 -1 -1 3 3 3 
51 51 51 3 3 12 12 12 3 
TORCH
0 0 0 0 0 0 0 0 0 
1 0 0 0 0 0 0 0 0 
0 0 0 0 0 0 0 0 0 
0 0 0 0 0 0 0 0 1 
0 0 0 0 0 0 0 0 0 
0 0 0 0 0 0 0 0 0 
0 0 0 0 0 0 0 0 0 
0 0 0 0 0 0 1 0 0 
0 0 0 0 0 0 0 0 0 
