TILEMAP
SIZE 8 8
PLAYER_START 0 0
NEXT_STAGE 0 0
FLOOR
0 0 0 0 0 0 0 0 
0 0 0 0 0 0 0 0 
0 0 0 0 0 0 0 0 
0 0 0 0 0 0 0 0 
0 0 0 0 0 0 0 0 
0 0 0 0 0 0 0 0 
0 0 0 0 0 0 0 0 
0 0 0 0 0 0 0 0 
WALL
1 1 1 1 1 1 1 1 
1 -1 -1 -1 -1 -1 -1 2 
1 -1 -1 -1 -1 -1 -1 7 
4 -1 -1 -1 -1 -1 -1 7 
4 -1 -1 -1 -1 -1 -1 7 
4 -1 -1 -1 -1 -1 -1 1 
1 -1 -1 -1 -1 -1 -1 1 
1 15 4 4 4 4 4 1 
