TILEMAP
SIZE 13 13
PLAYER_START 7 2
NEXT_STAGE 0,0
FLOOR
0 0 0 0 0 0 0 0 0 0 0 0 0 
0 0 0 0 0 0 0 0 0 0 0 0 0 
0 0 0 0 0 0 0 0 0 0 0 0 0 
0 0 0 0 0 0 0 0 0 0 0 0 0 
0 0 0 0 0 0 0 0 0 0 0 0 0 
0 0 0 0 0 0 0 0 0 0 0 0 0 
0 0 0 0 0 0 0 0 0 0 0 0 0 
0 0 0 0 0 0 0 0 0 0 0 0 0 
0 0 0 0 0 0 0 0 0 0 0 0 0 
0 0 0 0 0 0 0 0 0 0 0 0 0 
0 0 0 0 0 0 0 0 0 0 0 0 0 
0 0 0 0 0 0 0 0 0 0 0 0 0 
0 0 0 0 0 0 0 0 0 0 0 0 0 
WALL
58 58 58 58 58 58 58 58 58 58 58 58 58 
58 -1 -1 -1 -1 -1 -1 -1 -1 -1 -1 -1 58 
58 -1 -1 -1 -1 -1 -1 -1 -1 -1 -1 -1 58 
58 -1 -1 -1 -1 -1 -1 -1 -1 -1 -1 -1 58 
58 -1 -1 -1 -1 -1 -1 -1 -1 -1 -1 -1 58 
58 -1 -1 -1 -1 -1 -1 -1 -1 -1 -1 -1 58 
58 -1 -1 -1 -1 -1 -1 -1 -1 -1 -1 -1 58 
58 -1 -1 -1 -1 -1 -1 -1 -1 -1 -1 -1 58 
58 -1 -1 -1 -1 -1 -1 -1 -1 -1 -1 -1 58 
58 -1 -1 -1 -1 -1 -1 -1 -1 -1 -1 -1 58 
58 -1 -1 -1 -1 -1 -1 -1 -1 -1 -1 -1 58 
58 -1 -1 -1 -1 -1 -1 -1 -1 -1 -1 -1 58 
58 58 58 58 58 58 58 58 58 58 58 58 58 
