TILEMAP
SIZE 8 8
PLAYER_START 4 4
NEXT_STAGE 3 1
FLOOR
0 0 0 0 0 0 0 0 
0 0 0 0 0 0 0 0 
0 0 0 0 0 0 0 0 
0 0 0 0 0 0 0 0 
0 0 0 0 0 0 0 0 
0 0 0 0 0 0 0 0 
0 0 0 0 0 0 0 0 
0 0 0 0 0 0 0 0 
WALL
1 1 1 1 1 1 1 1 
1 -1 -1 -1 -1 -1 -1 1 
1 -1 -1 -1 -1 -1 -1 51 
51 -1 -1 -1 -1 -1 -1 51 
51 -1 -1 -1 -1 -1 -1 51 
1 -1 -1 -1 -1 -1 -1 1 
1 -1 -1 -1 -1 -1 -1 1 
1 1 51 51 51 51 51 1 
TORCH
1 0 0 0 0 0 0 0 
0 0 0 0 0 0 0 0 
0 0 0 0 0 0 0 0 
1 0 0 0 0 0 0 1 
0 0 0 0 0 0 0 0 
0 0 0 0 0 0 0 0 
1 0 0 0 0 0 0 1 
0 0 1 0 0 0 0 0 
