TILEMAP
SIZE 12 12
PLAYER_START 6 9
NEXT_STAGE 11 0
FLOOR
1 1 1 1 1 1 1 1 1 1 1 1 
1 1 1 1 1 1 1 1 1 1 1 1 
1 1 1 1 1 1 1 1 1 1 1 1 
1 1 1 1 1 1 1 1 1 1 1 1 
1 1 1 1 1 1 1 1 1 1 1 1 
1 1 1 1 1 1 1 1 1 1 1 1 
1 1 1 1 1 1 1 1 1 1 1 1 
1 1 1 1 1 1 1 1 1 1 1 1 
1 1 1 1 1 1 1 1 1 1 1 1 
1 1 1 1 1 1 1 1 1 1 1 1 
1 1 1 1 1 1 1 1 1 1 1 1 
1 1 1 1 1 1 1 1 1 1 1 1 
WALL
59 59 58 59 59 58 59 58 58 59 59 59 
58 -1 -1 -1 -1 -1 -1 -1 -1 -1 -1 59 
58 -1 -1 -1 -1 -1 -1 -1 -1 -1 -1 59 
58 -1 -1 -1 -1 -1 -1 -1 -1 -1 -1 59 
59 -1 -1 -1 -1 -1 -1 -1 -1 -1 -1 59 
59 -1 -1 -1 -1 -1 -1 -1 -1 -1 -1 58 
58 -1 -1 -1 -1 -1 -1 -1 -1 -1 -1 59 
59 -1 -1 -1 -1 -1 -1 -1 -1 -1 -1 59 
59 -1 -1 -1 -1 -1 -1 -1 -1 -1 -1 58 
59 -1 -1 -1 -1 -1 -1 -1 -1 -1 -1 58 
59 -1 -1 -1 -1 -1 -1 -1 -1 -1 -1 58 
59 58 58 58 59 59 59 59 59 59 59 59 
TORCH
1 0 1 0 1 0 0 1 0 1 0 1 
0 0 0 0 0 0 0 0 0 0 0 0 
1 0 0 0 0 0 0 0 0 0 0 1 
0 0 0 0 0 0 0 0 0 0 0 0 
1 0 0 0 0 0 0 0 0 0 0 1 
0 0 0 0 0 0 0 0 0 0 0 0 
1 0 0 0 0 0 0 0 0 0 0 1 
0 0 0 0 0 0 0 0 0 0 0 0 
1 0 0 0 0 0 0 0 0 0 0 1 
0 0 0 0 0 0 0 0 0 0 0 0 
0 0 0 0 0 0 0 0 0 0 0 0 
1 0 1 0 1 0 0 1 0 1 0 1 
