TILEMAP
SIZE 9 9
PLAYER_START 0 0
NEXT_STAGE 0 0
FLOOR
1 1 1 1 1 1 1 1 1 
1 1 1 1 1 1 1 1 1 
1 1 1 1 1 1 1 1 1 
1 1 1 1 1 1 1 1 1 
1 1 1 1 1 1 1 1 1 
1 1 1 1 1 1 1 1 1 
1 1 1 1 1 1 1 1 1 
1 1 1 1 1 1 1 1 1 
1 1 1 1 1 1 1 1 1 
WALL
3 3 3 12 12 12 3 51 51 
3 -1 -1 -1 -1 -1 -1 -1 51 
51 -1 -1 -1 3 -1 -1 -1 3 
51 -1 -1 -1 12 -1 -1 -1 3 
51 -1 -1 -1 12 3 -1 -1 3 
3 -1 3 -1 -1 -1 -1 -1 51 
3 -1 -1 -1 -1 -1 -1 -1 51 
51 -1 -1 -1 -1 -1 3 3 3 
51 51 51 3 3 12 12 12 3 
