TILEMAP
SIZE 20 20
FLOOR
0 0 0 0 0 0 38 38 0 0 0 0 38 0 0 38 0 0 0 0 
0 0 0 0 0 38 38 38 0 0 38 38 0 0 0 38 0 0 0 0 
0 0 0 0 38 0 38 0 0 38 0 0 0 0 38 0 0 0 0 0 
0 0 0 0 38 38 38 38 38 0 0 0 38 0 38 0 0 0 0 0 
0 0 0 38 38 0 0 38 38 38 38 38 38 0 0 0 0 0 38 38 
0 0 38 38 38 38 38 38 38 38 38 38 38 38 0 0 38 38 0 0 
38 38 38 38 38 0 0 38 38 38 38 38 38 38 38 38 0 0 0 38 
38 0 38 38 38 38 38 0 38 38 38 0 0 38 0 0 0 0 0 38 
0 0 38 38 38 38 0 0 38 38 38 38 38 0 0 0 0 0 0 38 
38 38 38 38 38 0 0 38 0 38 0 38 0 0 0 0 0 0 38 0 
0 0 38 38 38 0 38 38 0 38 38 0 38 38 0 38 38 38 38 0 
0 38 38 38 38 0 38 38 38 38 38 38 38 0 0 0 38 38 0 0 
0 38 38 38 38 38 38 38 38 38 0 0 0 0 38 38 0 0 0 0 
0 38 38 38 38 0 38 0 38 0 0 0 38 0 0 0 0 38 0 0 
38 0 0 0 0 0 0 0 0 0 0 38 0 0 0 0 38 0 0 38 
0 0 0 0 0 38 0 0 0 38 38 0 38 0 38 0 38 38 38 0 
0 0 0 0 38 0 0 0 0 38 38 38 38 0 38 0 38 0 0 0 
0 0 38 0 0 0 0 38 0 38 38 38 0 0 0 0 38 0 0 0 
38 38 0 0 38 38 0 38 38 0 38 38 0 0 0 0 38 38 38 38 
0 0 0 0 0 0 0 0 0 38 38 0 0 0 38 0 38 0 0 0 
WALL
-1 -1 -1 -1 -1 -1 -1 -1 -1 -1 -1 -1 -1 -1 -1 -1 -1 -1 -1 -1 
-1 -1 -1 -1 -1 -1 -1 -1 -1 -1 -1 -1 -1 -1 -1 -1 -1 -1 -1 -1 
-1 -1 -1 -1 -1 -1 -1 -1 -1 -1 -1 -1 -1 -1 -1 -1 -1 -1 -1 -1 
-1 -1 -1 -1 -1 -1 -1 -1 -1 -1 -1 -1 -1 -1 -1 -1 -1 -1 -1 -1 
-1 -1 -1 -1 -1 -1 -1 -1 -1 -1 -1 -1 -1 -1 -1 -1 -1 -1 -1 -1 
-1 -1 -1 -1 -1 -1 -1 -1 -1 -1 -1 -1 -1 -1 -1 -1 46 46 -1 -1 
-1 -1 -1 -1 -1 -1 -1 -1 46 46 46 46 46 46 46 46 46 -1 -1 -1 
-1 -1 -1 -1 -1 46 46 46 -1 -1 46 46 46 46 46 46 46 -1 -1 -1 
-1 -1 -1 -1 46 46 46 -1 46 46 46 46 46 46 46 -1 46 -1 -1 -1 
-1 -1 -1 -1 46 46 46 46 46 46 46 46 46 46 -1 46 46 -1 -1 -1 
-1 -1 46 46 46 46 46 46 46 46 46 46 46 46 46 -1 46 -1 -1 -1 
-1 -1 46 46 46 46 46 46 46 46 46 46 46 46 -1 46 46 -1 -1 -1 
-1 -1 -1 -1 46 46 46 46 46 46 -1 46 46 -1 46 -1 -1 -1 -1 -1 
-1 -1 -1 -1 -1 -1 46 46 46 -1 -1 -1 46 46 -1 -1 46 -1 -1 -1 
-1 -1 -1 -1 -1 46 46 46 46 46 -1 46 46 46 46 46 46 -1 -1 -1 
-1 -1 -1 -1 -1 46 -1 -1 -1 -1 -1 46 -1 46 46 -1 -1 -1 -1 -1 
-1 -1 -1 -1 -1 46 46 46 46 46 46 46 46 -1 -1 -1 -1 -1 -1 -1 
-1 -1 -1 -1 -1 -1 -1 -1 -1 -1 -1 -1 -1 -1 -1 -1 -1 -1 -1 -1 
-1 -1 -1 -1 -1 -1 -1 -1 -1 -1 -1 -1 -1 -1 -1 -1 -1 -1 -1 -1 
-1 -1 -1 -1 -1 -1 -1 -1 -1 -1 -1 -1 -1 -1 -1 -1 -1 -1 -1 -1 
