TILEMAP
SIZE 8 8
PLAYER_START 2 3
NEXT_STAGE 5 2
FLOOR
0 0 0 0 0 0 0 0 
0 0 0 0 0 0 0 0 
0 0 0 0 0 0 0 0 
0 0 0 0 0 0 0 0 
0 0 0 0 0 0 0 0 
0 0 0 0 0 0 0 0 
0 0 0 0 0 0 0 0 
0 0 0 0 0 0 0 0 
WALL
1 1 1 1 1 1 1 1 
15 -1 -1 -1 -1 -1 -1 2 
15 -1 -1 -1 -1 -1 -1 2 
15 -1 -1 -1 -1 -1 -1 2 
15 -1 -1 -1 -1 -1 -1 2 
1 -1 -1 -1 -1 -1 -1 1 
1 -1 -1 -1 -1 -1 -1 1 
1 15 15 15 15 51 51 1 
TORCH
0 0 0 0 0 0 0 0 
0 0 0 0 0 0 0 0 
1 0 0 0 0 0 0 0 
0 0 0 0 0 0 0 1 
0 0 0 0 0 0 0 0 
0 0 0 0 0 0 0 0 
0 0 0 0 0 0 0 0 
0 0 1 0 0 0 0 0 
