TILEMAP
SIZE 11 11
PLAYER_START 5 2
NEXT_STAGE 6 6
FLOOR
1 1 1 1 1 1 1 1 1 1 1 
1 1 1 1 1 1 1 1 1 1 1 
1 1 1 1 1 1 1 1 1 1 1 
1 1 1 1 1 1 1 1 1 1 1 
1 1 1 1 1 1 1 1 1 1 1 
1 1 1 1 1 1 1 1 1 1 1 
1 1 33 1 33 1 1 1 33 1 1 
1 1 1 1 1 1 1 1 1 1 1 
1 1 33 1 33 1 33 1 33 1 1 
1 1 1 1 1 1 1 1 1 1 1 
1 1 1 1 1 1 1 1 1 1 1 
WALL
57 57 57 57 57 57 57 57 57 57 57 
57 -1 -1 -1 -1 -1 -1 -1 -1 -1 57 
57 -1 -1 57 -1 -1 -1 57 -1 -1 57 
57 -1 -1 -1 -1 -1 -1 -1 -1 -1 57 
57 -1 -1 57 -1 -1 -1 57 -1 -1 57 
57 -1 -1 -1 -1 -1 -1 -1 -1 -1 57 
57 -1 -1 -1 -1 -1 -1 -1 -1 -1 57 
57 -1 -1 -1 -1 -1 -1 -1 -1 -1 57 
57 -1 -1 -1 -1 -1 -1 -1 -1 -1 57 
57 -1 -1 -1 -1 -1 -1 -1 -1 -1 57 
57 57 57 57 57 57 57 57 57 57 57 
TORCH
1 0 0 1 0 0 0 1 0 0 1 
0 0 0 0 0 0 0 0 0 0 0 
1 0 0 0 0 0 0 0 0 0 1 
0 0 0 0 0 0 0 0 0 0 0 
1 0 0 0 0 0 0 0 0 0 1 
0 0 0 0 0 0 0 0 0 0 0 
1 0 0 0 0 0 0 0 0 0 1 
0 0 0 0 0 0 0 0 0 0 0 
1 0 0 0 0 0 0 0 0 0 1 
0 0 0 0 0 0 0 0 0 0 0 
1 0 0 1 0 0 0 1 0 0 1 
