TILEMAP
SIZE 8 8
PLAYER_START 4 5
NEXT_STAGE 2 2
FLOOR
0 0 0 0 0 0 0 0 
0 0 0 0 0 0 0 0 
0 0 0 0 0 0 0 0 
0 0 0 0 0 0 0 0 
0 0 0 0 0 0 0 0 
0 0 0 0 0 0 0 0 
0 0 0 0 0 0 0 0 
0 0 0 0 0 0 0 0 
WALL
1 1 1 1 1 1 1 1 
1 -1 -1 -1 -1 -1 -1 2 
1 -1 -1 -1 -1 -1 -1 7 
4 -1 -1 -1 -1 -1 -1 7 
4 -1 -1 -1 -1 -1 -1 7 
4 -1 -1 -1 -1 -1 -1 1 
1 -1 -1 -1 -1 -1 -1 1 
1 15 4 4 4 4 4 1 
TORCH
0 0 0 0 0 0 0 0 
0 0 0 0 0 0 0 0 
0 0 0 0 0 0 0 1 
0 0 0 0 0 0 0 0 
1 0 0 0 0 0 0 0 
0 0 0 0 0 0 0 1 
0 0 0 0 0 0 0 0 
0 0 0 0 0 0 0 0 
