TILEMAP
SIZE 9 9
PLAYER_START 0 0
NEXT_STAGE 0 0
FLOOR
1 1 1 1 1 1 1 1 1 
1 1 1 1 1 1 1 1 1 
1 1 1 1 1 1 1 1 1 
1 1 1 1 1 1 1 1 1 
1 1 1 1 1 1 1 1 1 
1 1 1 1 1 1 1 1 1 
1 1 1 1 1 1 1 1 1 
1 1 1 1 1 1 1 1 1 
1 1 1 1 1 1 1 1 1 
WALL
0 0 0 0 0 0 0 0 0 
0 -1 -1 -1 -1 -1 -1 -1 0 
0 -1 -1 -1 -1 -1 -1 -1 0 
0 -1 -1 -1 -1 -1 -1 -1 0 
0 -1 -1 -1 -1 -1 -1 -1 0 
0 -1 -1 -1 -1 -1 -1 -1 0 
0 -1 -1 -1 -1 -1 -1 -1 0 
0 -1 -1 -1 -1 -1 -1 -1 0 
0 0 0 0 0 0 0 0 0 
